AAA = Authentication, Authorization, and Accounting — Authentication, Authorization, and Accounting
TG_3223 = Preview — Preview
ACL = Access Control List — Access Control List
AES = Advanced Encryption Standard — Advanced Encryption Standard
AES-256 = Advanced Encryption Standard 256-bit — Advanced Encryption Standard 256
AH = Authentication Header — Authentication Header
AI = Artificial Intelligence — Artificial Intelligence
AIS = Automated Indicator Sharing — Automated Indicator Sharing
ALE = Annualized Loss Expectancy — Annualized Loss Expectancy
AP = Access Point — Access Point
API = Application Programming Interface — Application Programming Interface
APT = Advanced Persistent Threat — Advanced Persistent Threat
ARO = Annualized Rate of Occurrence — Annualized Rate of Occurrence
ARP = Address Resolution Protocol — Address Resolution Protocol
ASLR = Address Space Layout Randomization — Address Space Layout Randomization
ATT&CK = Adversarial Tactics, Techniques, & Common Knowledge — Adversarial Tactics, Techniques, & Common Knowledge
AUP = Acceptable Use Policy — Acceptable Use Policy
AV = Antivirus — Antivirus
BASH = Bourne Again Shell — Bourne Again Shell
BCP = Business Continuity Planning — Business Continuity Planning
BGP = Border Gateway Protocol — Border Gateway Protocol
BIA = Business Impact Analysis — Business Impact Analysis
BIOS = Basic Input/Output System — Basic Input/Output System
BPA = Business Partners Agreement — Business Partners Agreement
BPDU = Bridge Protocol Data Unit — Bridge Protocol Data Unit
BYOD = Bring Your Own Device — Bring Your Own Device
CA = Certificate Authority — Certificate Authority
CAPTCHA = Completely Automated Public Turing Test To Tell Computers and Humans Apart — Completely Automated Public Turing Test To Tell Computers and Humans Apart
CAR = Corrective Action Report — Corrective Action Report
CASB = Cloud Access Security Broker — Cloud Access Security Broker
CBC = Cipher Block Chaining — Cipher Block Chaining
CCMP = Counter-Mode/CBC-Mac Protocol — Counter
CCTV = Closed Circuit Television — Closed Circuit Television
CFB = Cipher Feedback — Cipher Feedback
CHAP = Challenge Handshake Authentication Protocol — Challenge Handshake Authentication Protocol
CIA = Confidentiality, Integrity, Availability — Confidentiality, Integrity, Availability
CIO = Chief Information Officer — Chief Information Officer
CIRT = Computer Incident Response Team — Computer Incident Response Team
CMS = Content Management System — Content Management System
COOP = Continuity of Operations Planning — Continuity of Operations Planning
COPE = Corporate Owned, Personally Enabled — Corporate Owned, Personally Enabled
CP = Contingency Planning — Contingency Planning
CRC = Cyclical Redundancy Check — Cyclical Redundancy Check
CRL = Certificate Revocation List — Certificate Revocation List
CSO = Chief Security Officer — Chief Security Officer
CSP = Cloud Service Provider — Cloud Service Provider
CSR = Certificate Signing Request — Certificate Signing Request
CSRF = Cross-Site Request Forgery — Cross
CSU = Channel Service Unit — Channel Service Unit
CTM = Counter-Mode — Counter
CTO = Chief Technology Officer — Chief Technology Officer
CVE = Common Vulnerability Enumeration — Common Vulnerability Enumeration
CVSS = Common Vulnerability Scoring System — Common Vulnerability Scoring System
CYOD = Choose Your Own Device — Choose Your Own Device
DAC = Discretionary Access Control — Discretionary Access Control
DBA = Database Administrator — Database Administrator
DEP = Data Execution Prevention — Data Execution Prevention
DES = Digital Encryption Standard — Digital Encryption Standard
DHCP = Dynamic Host Configuration Protocol — Dynamic Host Configuration Protocol
DHE = Diffie-Hellman Ephemeral — Diffie
DKIM = Domain Keys Identified Mail — Domain Keys Identified Mail
DLL = Dynamic Link Library — Dynamic Link Library
DLP = Data Loss Prevention — Data Loss Prevention
DMARC = Domain Message Authentication Reporting and Conformance — Domain Message Authentication Reporting and Conformance
DNAT = Destination Network Address Transaction — Destination Network Address Transaction
DNS = Domain Name System — Domain Name System
DPO = Data Privacy Officer — Data Privacy Officer
DRP = Disaster Recovery Plan — Disaster Recovery Plan
DSA = Digital Signature Algorithm — Digital Signature Algorithm
DSL = Digital Subscriber Line — Digital Subscriber Line
EAP = Extensible Authentication Protocol — Extensible Authentication Protocol
ECB = Electronic Code Book — Electronic Code Book
ECC = Elliptic Curve Cryptography — Elliptic Curve Cryptography
ECDHE = Elliptic Curve Diffie-Hellman Ephemeral — Elliptic Curve Diffie
ECDSA = Elliptic Curve Digital Signature Algorithm — Elliptic Curve Digital Signature Algorithm
EDR = Endpoint Detection and Response — Endpoint Detection and Response
EFS = Encrypted File System — Encrypted File System
ERP = Enterprise Resource Planning — Enterprise Resource Planning
ESN = Electronic Serial Number — Electronic Serial Number
ESP = Encapsulated Security Payload — Encapsulated Security Payload
FACL = File System Access Control List — File System Access Control List
FDE = Full Disk Encryption — Full Disk Encryption
FIM = File Integrity Management — File Integrity Management
FPGA = Field Programmable Gate Array — Field Programmable Gate Array
FRR = False Rejection Rate — False Rejection Rate
FTP = File Transfer Protocol — File Transfer Protocol
FTPS = Secured File Transfer Protocol (TLS/SSL) — Secured File Transfer Protocol (TLS/SSL)
GCM = Galois Counter Mode — Galois Counter Mode
GDPR = General Data Protection Regulation — General Data Protection Regulation
GPG = GNU Privacy Guard — GNU Privacy Guard
GPO = Group Policy Object — Group Policy Object
GPS = Global Positioning System — Global Positioning System
GPU = Graphics Processing Unit — Graphics Processing Unit
GRE = Generic Routing Encapsulation — Generic Routing Encapsulation
HA = High Availability — High Availability
HDD = Hard Disk Drive — Hard Disk Drive
HIDS = Host-based Intrusion Detection System — Host
HIPS = Host-based Intrusion Prevention System — Host
HMAC = Hashed Message Authentication Code — Hashed Message Authentication Code
HOTP = HMAC-based One-Time Password — HMAC
HSM = Hardware Security Module — Hardware Security Module
HTML = Hypertext Markup Language — Hypertext Markup Language
HTTP = Hypertext Transfer Protocol — Hypertext Transfer Protocol
HTTPS = Hypertext Transfer Protocol Secure — Hypertext Transfer Protocol Secure
HVAC = Heating, Ventilation and Air Conditioning — Heating, Ventilation and Air Conditioning
IAM = Identity and Access Management — Identity and Access Management
ICMP = Internet Control Message Protocol — Internet Control Message Protocol
ICS = Industrial Control Systems — Industrial Control Systems
IDEA = International Data Encryption Algorithm — International Data Encryption Algorithm
IDF = Intermediate Distribution Frame — Intermediate Distribution Frame
IDS = Intrusion Detection System — Intrusion Detection System
IEEE = Institute of Electrical and Electronics Engineers — Institute of Electrical and Electronics Engineers
IKE = Internet Key Exchange — Internet Key Exchange
IM = Instant Messaging — Instant Messaging
IMAP = Internet Message Access Protocol — Internet Message Access Protocol
IP = Internet Protocol — Internet Protocol
IPS = Intrusion Prevention System — Intrusion Prevention System
IR = Incident Response — Incident Response
IRC = Internet Relay Chat — Internet Relay Chat
IRP = Incident Response Plan — Incident Response Plan
ISO = International Standards Organization — International Standards Organization
ISP = Internet Service Provider — Internet Service Provider
ISSO = Information Systems Security Officer — Information Systems Security Officer
IV = Initialization Vector — Initialization Vector
KDC = Key Distribution Center — Key Distribution Center
KEK = Key Encryption Key — Key Encryption Key
L2TP = Layer 2 Tunneling Protocol — Layer 2 Tunneling Protocol
LAN = Local Area Network — Local Area Network
LDAP = Lightweight Directory Access Protocol — Lightweight Directory Access Protocol
LEAP = Lightweight Extensible Authentication Protocol — Lightweight Extensible Authentication Protocol
MAN = Metropolitan Area Network — Metropolitan Area Network
MBR = Master Boot Record — Master Boot Record
MD5 = Message Digest 5 — Message Digest 5
MDF = Main Distribution Frame — Main Distribution Frame
MDM = Mobile Device Management — Mobile Device Management
MFA = Multi-Factor Authentication — Multi
MFD = Multifunction Device — Multifunction Device
MFP = Multifunction Printer — Multifunction Printer
ML = Machine Learning — Machine Learning
MMS = Multimedia Message Service — Multimedia Message Service
MOA = Memorandum of Agreement — Memorandum of Agreement
MOU = Memorandum of Understanding — Memorandum of Understanding
MPLS = Multi-Protocol Label Switching — Multi
MSA = Master Service Agreement — Master Service Agreement
MSCHAP = Microsoft Challenge Handshake Authentication Protocol — Microsoft Challenge Handshake Authentication Protocol
MSP = Managed Service Provider — Managed Service Provider
MSSP = Managed Security Service Provider — Managed Security Service Provider
MTBF = Mean Time Between Failures — Mean Time Between Failures
MTTF = Mean Time to Failure — Mean Time to Failure
MTTR = Mean Time to Recover — Mean Time to Recover
MTU = Maximum Transmission Unit — Maximum Transmission Unit
NAC = Network Access Control — Network Access Control
NAT = Network Address Translation — Network Address Translation
NDA = Non-Disclosure Agreement — Non
NFC = Near Field Communication — Near Field Communication
NGFW = Next Generation Firewall — Next Generation Firewall
NIDS = Network-based Intrusion Detection System — Network
NIPS = Network-based Intrusion Prevention System — Network
NIST = National Institute of Standards and Technology — National Institute of Standards and Technology
NTFS = New Technology File System — New Technology File System
NTLM = New Technology LAN Manager — New Technology LAN Manager
NTP = Network Time Protocol — Network Time Protocol
OAUTH = Open Authorization — Open Authorization
OCSP = Online Certificate Status Protocol — Online Certificate Status Protocol
OID = Object Identifier — Object Identifier
OS = Operating System — Operating System
OSINT = Open Source Intelligence — Open Source Intelligence
OSPF = Open Shortest Path First — Open Shortest Path First
OT = Operational Technology — Operational Technology
OTA = Over-the-Air — Over
OVAL = Open Vulnerability Assessment Language — Open Vulnerability Assessment Language
P12 = PKCS #12 — PKCS #12
PKCS #12 = P2P — P2P
P2P = Peer-to-Peer — Peer
PAC = Proxy Auto Configuration — Proxy Auto Configuration
PAM = Pluggable Authentication Modules — Pluggable Authentication Modules
PAP = Password Authentication Protocol — Password Authentication Protocol
PAT = Port Address Translation — Port Address Translation
PBKDF2 = Password-based Key Derivation Function 2 — Password
PBX = Private Branch Exchange — Private Branch Exchange
PCAP = Packet Capture — Packet Capture
PCI DSS = Payment Card Industry Data Security Standard — Payment Card Industry Data Security Standard
PDU = Power Distribution Unit — Power Distribution Unit
PEAP = Protected Extensible Authentication Protocol — Protected Extensible Authentication Protocol
PED = Personal Electronic Device — Personal Electronic Device
PEM = Privacy Enhanced Mail — Privacy Enhanced Mail
PFS = Perfect Forward Secrecy — Perfect Forward Secrecy
PGP = Pretty Good Privacy — Pretty Good Privacy
PHI = Personal Health Information — Personal Health Information
PII = Personally Identifiable Information — Personally Identifiable Information
PIV = Personal Identity Verification — Personal Identity Verification
PKCS = Public Key Cryptography Standards — Public Key Cryptography Standards
PKI = Public Key Infrastructure — Public Key Infrastructure
POP = Post Office Protocol — Post Office Protocol
POTS = Plain Old Telephone Service — Plain Old Telephone Service
PPP = Point-to-Point Protocol — Point
PPTP = Point-to-Point Tunneling Protocol — Point
PSK = Pre-Shared Key — Pre
PTZ = Pan-Tilt-Zoom — Pan
PUP = Potentially Unwanted Program — Potentially Unwanted Program
RA = Recovery Agent — Recovery Agent
RACE = Research and Development in Advanced Communications Technologies in Europe — Research and Development in Advanced Communications Technologies in Europe
RAD = Rapid Application Development — Rapid Application Development
RADIUS = Remote Authentication Dial-In User Service — Remote Authentication Dial
RAID = Redundant Array of Inexpensive Disks — Redundant Array of Inexpensive Disks
RAS = Remote Access Server — Remote Access Server
RAT = Remote Access Trojan — Remote Access Trojan
RBAC = Rule/Role Based Access Control — Rule/Role Based Access Control
RC4 = Rivest Cipher v4 — Rivest Cipher v4
RDP = Remote Desktop Protocol — Remote Desktop Protocol
RFID = Radio Frequency Identifier — Radio Frequency Identifier
RIPEMD = RACE Integrity Primitives Evaluation Message Digest — RACE Integrity Primitives Evaluation Message Digest
ROI = Return on Investment — Return on Investment
RPO = Recovery Point Objective — Recovery Point Objective
RSA = Rivest, Shamir, & Adleman — Rivest, Shamir, & Adleman
RTBH = Remotely Triggered Black Hole — Remotely Triggered Black Hole
RTO = Recovery Time Objective — Recovery Time Objective
RTOS = Real-time Operating System — Real
RTP = Real-time Transport Protocol — Real
S/MIME = Secure/Multipurpose Internet Mail Extensions — Secure/Multipurpose Internet Mail Extensions
SAE = Simultaneous Authentication of Equals — Simultaneous Authentication of Equals
SAML = Security Assertions Markup Language — Security Assertions Markup Language
SASE = Secure Access Service Edge — Secure Access Service Edge
SCADA = Supervisory Control and Data Acquisition — Supervisory Control and Data Acquisition
SCAP = Security Content Automation Protocol — Security Content Automation Protocol
SCEP = Simple Certificate Enrollment Protocol — Simple Certificate Enrollment Protocol
SD-WAN = Software-defined Wide Area Network — Software
SDK = Software Development Kit — Software Development Kit
SDLC = Software Development Life Cycle — Software Development Life Cycle
SDLM = Software Development Life Cycle Methodology — Software Development Life Cycle Methodology
SDN = Software Defined Networking — Software Defined Networking
SED = Self-Encrypting Drives — Self
SEH = Structured Exception Handler — Structured Exception Handler
SFTP = Secured File Transfer Protocol (SSH) — Secured File Transfer Protocol (SSH)
SHA = Secure Hashing Algorithm — Secure Hashing Algorithm
SHTTP = Secure Hypertext Transfer Protocol — Secure Hypertext Transfer Protocol
SIEM = Security Information and Event Management — Security Information and Event Management
SIM = Subscriber Identity Module — Subscriber Identity Module
SLA = Service Level Agreement — Service Level Agreement
SLE = Single Loss Expectancy — Single Loss Expectancy
SMS = Short Message Service — Short Message Service
SMTP = Simple Mail Transfer Protocol — Simple Mail Transfer Protocol
SMTPS = Simple Mail Transfer Protocol Secure — Simple Mail Transfer Protocol Secure
SNMP = Simple Network Management Protocol — Simple Network Management Protocol
SOAP = Simple Object Access Protocol — Simple Object Access Protocol
SOAR = Security Orchestration, Automation, Response — Security Orchestration, Automation, Response
SOW = Statement of Work — Statement of Work
SPF = Sender Policy Framework — Sender Policy Framework
SPIM = Spam over Internet Messaging — Spam over Internet Messaging
SQL = Structured Query Language — Structured Query Language
SRTP = Secure Real-Time Protocol — Secure Real
SSD = Solid State Drive — Solid State Drive
SSH = Secure Shell — Secure Shell
SSL = Secure Sockets Layer — Secure Sockets Layer
SSO = Single Sign On — Single Sign On
STIX = Structured Threat Information eXchange — Structured Threat Information eXchange
SWG = Secure Web Gateway — Secure Web Gateway
TACACS+ = Terminal Access Controller Access Control System — Terminal Access Controller Access Control System
TAXII = Trusted Automated eXchange of Intelligence Information — Trusted Automated eXchange of Intelligence Information
TCP/IP = Transmission Control Protocol/Internet Protocol — Transmission Control Protocol/Internet Protocol
TGT = Ticket Granting Ticket — Ticket Granting Ticket
TKIP = Temporal Key Integrity Protocol — Temporal Key Integrity Protocol
TLS = Transport Layer Security — Transport Layer Security
TOC = Time-of-Check — Time
TOTP = Time-based One-Time Password — Time
TOU = Time-of-Use — Time
TPM = Trusted Platform Module — Trusted Platform Module
TTP = Tactics, Techniques, and Procedures — Tactics, Techniques, and Procedures
TSIG = Transaction Signature — Transaction Signature
UAT = User Acceptance Testing — User Acceptance Testing
UAV = Unmanned Aerial Vehicle — Unmanned Aerial Vehicle
UDP = User Datagram Protocol — User Datagram Protocol
UEFI = Unified Extensible Firmware Interface — Unified Extensible Firmware Interface
UEM = Unified Endpoint Management — Unified Endpoint Management
UPS = Uninterruptible Power Supply — Uninterruptible Power Supply
URI = Uniform Resource Identifier — Uniform Resource Identifier
URL = Uniform Resource Locator — Uniform Resource Locator
USB = Universal Serial Bus — Universal Serial Bus
USB OTG = USB On-The-Go — USB On
UTM = Unified Threat Management — Unified Threat Management
UTP = Unshielded Twisted Pair — Unshielded Twisted Pair
VBA = Visual Basic — Visual Basic
VDE = Virtual Desktop Environment — Virtual Desktop Environment
VDI = Virtual Desktop Infrastructure — Virtual Desktop Infrastructure
VLAN = Virtual Local Area Network — Virtual Local Area Network
VLSM = Variable Length Subnet Masking — Variable Length Subnet Masking
VM = Virtual Machine — Virtual Machine
VPC = Virtual Private Cloud — Virtual Private Cloud
VPN = Virtual Private Network — Virtual Private Network
VTC = Video Teleconferencing — Video Teleconferencing
WAF = Web Application Firewall — Web Application Firewall
WAP = Wireless Access Point — Wireless Access Point
WEP = Wired Equivalent Privacy — Wired Equivalent Privacy
WIDS = Wireless Intrusion Detection System — Wireless Intrusion Detection System
WIPS = Wireless Intrusion Prevention System — Wireless Intrusion Prevention System
WO = Work Order — Work Order
WPA = Wi-Fi Protected Access — Wi
WPS = Wi-Fi Protected Setup — Wi
WTLS = Wireless TLS — Wireless TLS
XDR = Extended Detection and Response — Extended Detection and Response
XML = Extensible Markup Language — Extensible Markup Language
XOR = Exclusive Or — Exclusive Or
XSRF = Cross-Site Request Forgery — Cross
XSS = Cross-Site Scripting — Cross